11111111111111111111111111111111111
1E000000000C00000000000000000000001
10000000000000000000000000000000001
11111111111111111111111111000111111
100000000000000000000000000C0000001
10000000000000000000000000000000001
10C01111111111111111111111111111111
100000000C000000000000000000000CC01
1000000000000000000000000000000CC01
11111111110001111111111111111111111
10000000000001000000000000000000001
10000000000001000000000000000000001
10001111111111000000001111110000111
10000000000001000000001000000000001
10000000000000000000001000000000001
1000000000000100000000100P000000001
11111111111111111111111111111111111