111111111111111
10C000001C01001
10E0001010010C1
101111101001011
100000000000001
111001111111111
100000010000001
1C1111000000101
1000000100001C1
111111111110111
1P00000000000C1
111111111111111