111111
1C00E1
100001
1C00P1
111111