111111111111111
1000010001000C1
10E001000100001
100011100111111
110000000000001
101000000000001
100100000001101
1C0100000001C01
111111111001111
1P00000000000C1
111111111111111