111111111111111
10000CC000010C1
100111111001001
100000000000001
110000000001111
1C1000000000001
110100000010011
1000100000100C1
10E001000010001
1000001000100P1
111111111111111
