111111111111111
10E0011100CCC01
111110000000001
100000000000001
1C0C10000011101
111110000010001
100000000010C01
111111100111111
1C00000000000P1
111111111111111