1111111111111
1P0000E00C001
1111111111111