111111111111
100000000001
1001C1000E01
1001C1000001
1P01C1111111
1111C1000001
100001000001
1C0000000001
111111111111