1111111111111111111111111111111111111111
1E000000000C0000000000000000000000000001
1000000000000000000000000000000000000001
1111111111111111111111111111111111110C01
100000000000000000000000000C000000000001
1000000000000000000000000000000000000001
10C0111111111111111111111111111111111111
100000000C000000000000000000000000000001
10000000000000000000000000000000000000P1
1111111111111111111111111111111111111111