1111111111111111111111111111111111111111
1000000000000000000000000000000000000001
1000000000000000000000000000000000000001
1111111111111111111111111111111111110001
1000000000000000000000000000000000000001
1000000000000000000000000000000000000001
1000111111111111111111111111111111111111
1000000000000000000000000000000000000001
1000000000000000000000000000000000000001
1111111111111111111111111111111111111111