111111111111
10000C000001
1P0001000E01
111111111111