111111111111
100000000001
100001000001
111111111111