11111111111111111111111111
10E0000000000000000000CC01
1000000000000000000000CC01
11111111111111C00011111111
1CCCCCC0000000000000CCCC01
11111111111111111110000001
10000000000000000010000001
111100000111110C0010000001
10000000000001000010000001
11111111110001000010000001
10000000000001000000000001
1P000000010C010000100CC001
11111111111111111111111111
