111111111111111111111111111111
10E0000000000000000000000000C1
100000000000000000000000000001
11111111100000C000001111111111
1C0000000000000000000000000001
100000000000000000000000000P01
111111111111111111111111111111