111111
1C10E1
101001
111001
1C00P1
111111